xxxxxxxxxxxxxxxxxxxxxxxx
x .    .          .  . x
x   *   .        . . o x
x  .  .           . .  x
xxxxxxxx  * xxxxxxxxxxxx
x                  x B x
x A x   .      x . x U x
x                  x Z x
x  Ax          x . xxxxx
x                  x A x
xxxxxxxx A  xxxxxxxx * x
x                      x
x                      x
x     xxxxxxxx         x
x     x      x         x
x     x      x         x
x     xxx##xxx     xxxxx
x                  x ;)x
x                  x   x
xxxxxxxxxxxxxxxxxxxxxxxx